烟感报警器	安防智能化体系
门磁开关	安防智能化体系
煤气泄漏报警器	安防智能化体系
紧急报警	安防智能化体系
接收	安防智能化体系
监控设备	安防智能化体系
家庭智能终端	安防智能化体系
红外探测器	安防智能化体系
多媒体箱	安防智能化体系
对讲机	安防智能化体系
传输插孔	安防智能化体系
玻璃破碎探测器	安防智能化体系
灶台	厨房
燃气	厨房
炉具	厨房
角阀	厨房
橱柜	厨房
油烟机	厨房
水泵	地下室
楼层显示	电梯系统
轿箱	电梯系统
呼梯按钮	电梯系统
噪音	房间环保
有害气体	房间环保
自动抄表系统	给排水系统
水表箱	给排水系统
水表	给排水系统
排水泵	给排水系统
给水泵	给排水系统
阀门类	给排水系统
暖气片	供暖设施
地热管线	供暖设施
地热阀门	供暖设施
洗衣机	电器设施
洗碗机	电器设施
微波炉	电器设施
热水器	电器设施
烤箱	电器设施
净水器	电器设施
电热水器	电器设施
电冰箱	电器设施
太阳能	电器设施
燃气角阀	燃气设备系统
燃气减压阀	燃气设备系统
燃气计量表	燃气设备系统
玄关柜	入户玄关
入户门	入户玄关
娱乐休闲设施	室外设施
游泳池	室外设施
停车位（停车卡）	室外设施
水景设备	室外设施
室外照明	室外设施
人行步道	室外设施
垃圾收集站	室外设施
公交站牌	室外设施
出入装置	室外设施
车行道	室外设施
浴缸	卫生间
浴厕配件	卫生间
浴霸	卫生间
马桶	卫生间
淋浴屏	卫生间
镜面	卫生间
洁具	卫生间
洁柜	卫生间
沉箱	卫生间
衣柜	卧室
消火栓箱	消防系统
消防管道	消防系统
破玻按钮	消防系统
控制盘	消防系统
警铃	消防系统
广播	消防系统
太阳能照明	新能源系统
太阳能热水器	新能源系统
阳台柜	阳台
入户花园	园林绿化
铺装	园林绿化
苗木	园林绿化
草坪	庭院
雨蓬檐沟	庭院